1111111111111111
1CCCCCC1CCCCCCC1
1CC11C1111CCC1C1
11CCCCC1CCCCCCC1
1CCCC111CC111C11
1CC1CC1CCCCCCCC1
1C11111CCC111C11
1CCCCCCCCC1CCCC1
1C11111CC1111CC1
1CECCCCCCCCCCCC1
11111111111111C1
11111111111111C1
1CCCCCCCCCCCCCP1
1111111111111111
