1111111111111111
1000000100000001
1C11101111000101
11000001000000C1
1000011100111011
1C01001000000001
1011111000111011
1C00001000100001
1000111001111001
10E0000000000C01
1111111111111101
1111111111111101
1000000000000001
1111111111111101
1000000000000001
1000000000000001
1000000000000001
1000000000000001
1000000000000001
1000000000000001
1000000000000001
1000000000000001
1000000000000001
1000000000000001
1000000000000001
1000000000000001
1000000000000001
1000000000000001
1000000000000001
1000000000000001
10000000000000P1
1111111111111111
